0 0 0 0 0 0 0 0 0 0 0 0 0 0 0 0 0 0 0 0
0 0 0 0 0 0 0 0 0 0 0 0 0 0 0 0 0 0 0 0
0 0 0 0 0 0 0 4 4 6 0 0 0 0 0 0 0 0 0 0
0 0 0 0 0 5 0 0 0 0 5 0 0 0 0 0 0 0 0 0
0 0 0 0 6 0 6 0 0 4 0 0 0 0 0 0 0 0 0 0
0 0 0 5 0 0 0 0 0 4 0 0 0 0 0 0 0 0 0 0
0 0 0 0 0 0 7 0 0 0 0 0 0 0 0 0 0 0 0 0
0 0 0 0 0 7 7 7 0 0 0 0 0 0 5 2 6 0 0 0
0 0 0 0 0 0 7 0 0 0 0 0 4 0 0 0 0 6 0 0
0 0 0 0 0 0 6 0 0 3 0 0 3 0 1 0 0 0 0 0
0 0 0 0 0 5 0 0 0 0 0 0 4 5 0 7 0 0 0 0
0 0 0 0 0 0 0 0 0 0 0 0 0 0 0 0 0 0 0 0